11111111111111111111111100000000000000111111111111111111111111
10000000000000000000000100000000000000100000000000000000000001
10000000000000000000000100000000000000100000000000000000000001
10000000000000000000000100000000000000100000000000000000000001
10000000000000000000000100000000000000100005000000000000000001
10000000000000000000000100000000000000100000000000000000000001
10000000000200000000000100000000000000100000000000000000000001
10000000000000000000000100000000000000100000000000000000000001
10000000000000000000000100000000000000100000000000000000000001
10000000000000000000000100000000000000100000000000000000000001
10000000000000000000000100000000000000100000000000000000000001
10000000000000000000000100000000000000100000000000000000000001
11111100000011111111111100000000000000111111111111110000001111
00000100000010000000000000000000000000000000000000010000001000
00000100000010000000000000000000000000000000000000010000001000
00000100000010000000000000000000000000000000000000010000001000
00000100000010000000000000000000000000000000000000010000001000
00000100000010000000000000000000000000000000000000010000001000
00000100000010000000000000000000000000000000000000010000001000
00000100000010000000000000000000000000000000000000010000001000
11111100000011111111111100000000000000111111111111110000001111
10000000000000000000000100000000000000100000000000000000000001
10000000000000000000000100000000000000100000000000000000000001
10000000000000000000000100000000000000100000000000000000000001
10000000000000000000000111111111111111100000000000000000000001
10000000000000000000000000000000000000000000000000000000000001
10000000000000000400000000000000000000000000000000300000000001
10000000000000000000000000000000000000000000000000000000000001
10000000000000000000000111111111111111100000000000000000000001
10000000000000000000000100000000000000100000000000000000000001
10000000000000000000000100000000000000100000000000000000000001
10000000000000000000000100000000000000100000000000000000000001
11111111111111111111111100000000000000111111111111111111111111